20 31
00000000000000000000000000000
01111111100000000000111111110
01000100100000000000100100010
01111111110000000001111111110
01000100011000000011000100010
01111100001100000110000111110
01010111111110001111111101010
01010101010100000101010101010
01111111111110001111111111110
00000111100000000000111100000
00000100100000000000100100000
01111100111111111111100111110
01010101010100000101010101010
01010111111110001111111101010
01111100001100000110000111110
01000100011000000011000100010
01111111110000000001111111110
01000100100000000000100100010
01111111100000000000111111110
00000000000000000000000000000
